-------------------
  0 1 2 3 4 5 6 7 8
0 * - - - - - - - -
1 - - T - - - - - -
2 - - - - - - - Z -
3 - - - - - - Z K Z
4 - - - - - - - Z -
5 - - - - - - - - -
6 R Z Z Z - - - - -
7 C Z D Z - - - - -
8 - Z Z Z - - - - -
-------------------
* - Jack,
D - Davy,
K - Kraken,
R - Rock,
C - Chest,
T - Tortuga.
