-------------------
  0 1 2 3 4 5 6 7 8
0 Z*Z Z - - - - - -
1 Z D Z - T - - - -
2 Z Z Z - - - - Z -
3 - - - - - - Z K Z
4 - - - - - - - Z -
5 - - - - - - - - -
6 R - - - - - - - -
7 C - - - - - - - -
8 - - - - - - - - -
-------------------
* - Jack,
D - Davy,
K - Kraken,
R - Rock,
C - Chest,
T - Tortuga.
